1111111111111111111111111111111111
100000000000000C00000C0000000000E1
1010010100100000101001000000010101
1C10010010101010001001000000010101
1PC000000C00C00000000CCCCC000000C1
1111111111111111111111111111111111
